-1   -1   -1   -1   -1   -1   -1   -1   -1   -1   -1   5   5   -1   -1   -1   -1   -1   -1   -1   -1   -1   -1   -1
-1   -1   -1   -1   -1   -1   -1   -1   -1   -1   -1  -1  -1   -1   -1   -1   -1   -1   -1   -1   -1   -1   -1   -1
-1   -1   -1   -1   -1   -1   -1   -1   -1   -1   -1  -1  -1   -1   -1   -1   -1   -1   -1   -1   -1   -1   -1   -1
-1   -1   -1   -1   -1   -1   -1   -1   -1   -1   -1  -1  -1   -1   -1   -1   -1   -1   -1   -1   -1   -1   -1   -1
-1   -1   -1   -1   -1   -1   -1   -1   -1   -1   -1  -1  -1   -1   -1   -1   -1   -1   -1   -1   -1   -1   -1   -1
-1    0    0    0    0    0    0    0    0    0    0   0   0    0    0    0    0    0    0    0    0    0    0   -1
-1    0    0    0    0    0    0    0    0    0    0   0   0    0    0    0    0    0    0    0    0    0    0   -1
 6    0    0    0    0    0    0    0    0    0    0   0   0    0    0    0    0    0    0    0    0    0    0    7
 6    0    0    0    0    0    0    0    0    0    0   0   0    0    0    0    0    0    0    0    0    0    0    7
-1    0    0    0    0    0    0    0    0    0    0   0   0    0    0    0    0    0    0    0    0    0    0   -1
-1    0    0    0    0    0    0    0    0    0    0   0   0    0    0    0    0    0    0    0    0    0    0   -1
-1    0    0    0    0    0    0    0    0    0    0   0   0    0    0    0    0    0    0    0    0    0    0   -1
-1    0    0    0    0    0    0    0    0    0    0   0   0    0    0    0    0    0    0    0    0    0    0   -1
-1    0    0    0    0    0    0    0    0    0    0   0   0    0    0    0    0    0    0    0    0    0    0   -1
-1    0    0    0    0    0    0    0    0    0    0   0   0    0    0    0    0    0    0    0    0    0    0   -1
-1   -1   -1   -1   -1   -1   -1   -1   -1   -1   -1   1   1   -1   -1   -1   -1   -1   -1   -1   -1   -1   -1   -1